NO ./textures/north.xpm
SO ./textures/south.xpm
WE ./textures/west.xpm
EA ./textures/east.xpm

F 100,100,100
C 200,200,200

1111111111
1000000001
1000110001
10N0000001
1000110001
1000000001
1111111111
