NO ./textures/north.xpm
SO ./textures/south.xpm
WE ./textures/west.xpm
EA ./textures/east.xpm

F 10,100,100
C 200,200,200

1111111
1001
10000001
1111111
